*****XX****X********XXXX
XX******XX***XXXXX***XXX
XX***XXX***XXXXX****XXXX
XX***XXXXXXXXXXXXXX****X
*****XXXXXX****XX***XXXX
XX****X*****************
